XXXXXXX
XE   .X
X   X X
X   X X
X . X X
X   X X
X   X X
X   X X
X   X X
X .   X
XG   .X
XXXXXXX